#############################################
#           PARKING SIMULATOR MAP 2         #
#-------------------------------------------#
# ENTRY ->
#
#  [P][P][P][P][P][P][P][P][P][P]          #
#  [P][P][P][P][P][P][P][P][P][P]          #
#
#                 EXIT ->
#############################################
