##########################################################################################
                                                                                         #
                                                                                         #
#                                                                                        #
#                                                                                        #
#                                                                                        #
#                                                                                        #
####                #### ####                      #### ####                          ####
#  ░                  ░  #  ░                        ░  #  ░                          ░  #
#  ░                  ░  #  ░                        ░  #  ░                          ░  #
####                #### ####                      #### ####                          ####
#  ░                  ░  #  ░                        ░  #  ░                          ░  #
#  ░                  ░  #  ░                        ░  #  ░                          ░  #
####                #### ####                      #### ####                          ####
#  ░                  ░  #  ░                        ░  #  ░                          ░  #
#  ░                  ░  #  ░                        ░  #  ░                          ░  #
####                #### ####                      #### ####                          ####
#  ░                  ░  #  ░                        ░  #  ░                          ░  #
#  ░                  ░  #  ░                        ░  #  ░                          ░  #
####                #### ####                      #### ####                          ####
#  ░                  ░  #  ░                        ░  #  ░                          ░  #
#  ░                  ░  #  ░                        ░  #  ░                          ░  #
####                #### ####                      #### ####                          ####
#  ░                  ░  #  ░                        ░  #  ░                          ░  #
#  ░                  ░  #  ░                        ░  #  ░                          ░  #
####                #### ####                      #### ####                          ####
#  ░                  ░  #  ░                        ░  #  ░                          ░  #
#  ░                  ░  #  ░                        ░  #  ░                          ░  #
####                #### ####                      #### ####                          ####
#                                                                                        #
#                                                                                        #
#                                                                                        #
#
#
#
##########################################################################################